W B B W B B X W B X X G B B G B G G B B G X X X 
G W G B W W B W W B W W W G W W W B B B W G G X 
B W X X X G G X W G G B W G G G G G X X G X X W 
G B B G B X B B G B B W G B W B G B X W G W W W 
B G B W W B X B X B X G X W B G B G W B X W W X 
B G B B G B G B G G G W W B X G X X X B W B B G 
X G W B B B W W B G B W W X G X B W B X X X B X 
G W X G B G X B G G B B G W W G B G B G X W W B 
B B X W X G W B X X G W B G W G X W G W G X W X 
G B B X W X W G G W X X X W X X G B B G G G B G 
B G B G B X W X W B G X X B W W G B G X G G X X 
B X B W X X B G B W W X X G B X B W W W B G X B 
B X X G X W W G B B G X W G B G B G W B B X G W 
W B X G G G B G B G W B X W X B B W W W W W G X 
G G X W G G X G X W B W G G G B B G B G W X G W 
G W B X X G X X X W W X G G W G X W B G B B W W 
B G X X W B X G X W W W B W W G B X G W X X G W 
W X G W B B B G B W W B G W X G W W G G X W X B 
B X X B W X X W B G W B X B G W W B X G G W X G 
B W G G B X X W W X B B X W G G W G W B X X W X 
X W W W W W X W B G X X G G X W W X X W G W W B 
X W B B X W G W B W B G X B B X G G B B X W W W 
W G W G W W B G W W G W X W B B W X B X W G G G 
W B W X W X G X W G G G W X W X B X X X W G B W