G W X B G W W X W X W W X X G X X X X G G X G W G G X W G B W G B X G B X G W X B G X X B G X X 
W G B W G W W X B B G X W W X W G B X B B X W B X G B G W X X X G B B G B G G X G X B B W B X X 
W G W X W X G X W G B W X B X B W W X X X B W G W W W X W W B X X B X X X G B W G B W X W B W X 
X W B W B B X B B B G B W B G W G G G X G W B G G W W G G W G B W B B G X W X W G X X G B X G W 
B X B B X X B G X W X G X G X X X G W W W W X B B W B W X X W G W X G G W G X G G W G G G X G B 
G W B G B G G B W B W B B B X G B W W X G W B B W G W B W G W G G W X G X G X G G B B W G W B G 
X X X W X X G X B G G G G X B X G B G G W W G W W X B X G B B G W X G X X W W B B G X B X W X W 
B B G G G W G B G B G B G B B B W G X X X W W B B W G B B X G W W X W X W W X W W G G B G X X W 
W G B G G X B G G X W G G B G G W X B X G W B X B X W G B G G G W W G B W X G B X W B W W G B B 
X X B X G B G B B B W W X B W G B B W B G W G W G G W B X X G X G G G X X W X G W G B G G B G W 
B B X W G G G X W G B B X W B B X G G X W B G G X B G G G W W B G X B W X X B X G W B G W X X W 
G W X X X G W X B X B X B B W G B W X G B B W X B G X X G X B G G W B X B X X X B G X W G G X X 
B B W W B B W X X X B G B W G W W X X G B X B G G B G B G B G W W B B G X B X G G W G W W X B W 
G X W X X B X B X B W G G X B B B G B W W B X G B G B B W G X G G W W W G W X B B G W X G B W B 
W W X W B B G B X G G B B B G G X B W X W B B W G X G W X B G X X X W G B X W X B W B W X G G W 
B G X B W B X G X G G W W B X B B B W B B B B G G B G G G W B W X X B G B G X W G B B G W B W G 
B B B G B W X G B X G X G G W G G B B G B B B G G W G B X W W G X B B B G G G B W B X B B X X W 
W W X B B G W X G G W B W B W G W B G W G W W G W W X G W G X X W B G X X B W X W W W B X W B X 
X B W B G W X X G G G G W G X W G B X W B G X B B W B X B W X X G W G G G X W G G W W B W W X W 
B B B W G W G W X G W X G G B G B B X W B B G X W G B W W B W G B W B W W G B W X W B B B X B G 
B W W B X G G X X X X W B B G B W W G G G G X G W B W G G B W B B X G W X W G G W G B B B G X B 
W X G G G B X X G W X G B B X B X B G B W G X X G G X G G G W W X G B W W B X B B G X X X W W X 
W X W W W W G X W G W X G B X B W B X X X W X W B X X G B X B X X G G G X X W B W X X G G W B B 
X G G X X G X W B G X X G W G X G B B G B B G W B B W B B X X W G X X B X B B X W G B X G W W B 
B W B G G B B W G W X B X G X X X G W W G B X X X X W W X G W G B W B W B X W B G G B X B X X B 
X X W W W G G B G G W G W W G W X X G B G W G W W X B G G X G X B W X G W W G G W G B W G X X W 
B B X B W G W G W W W G B X B X B X B X X W W X X B G X B W X B X W W W X W W X W W X G G X X B 
G X B G G B B G X G B X G X G W W X W B X W X X G G G G G B G X X G B B B X X W G G W G B B B X 
W W B X B B X B B G B G B G G X B B W B G W B W X W X X G B W B G W W B W G X G X W G B W B W G 
B X B W X G X B G B G B B G B X W B W W X G B B B G X B W W W B W B G B G X G X B X X W X B W W 
W W B G B X G B B B B B G G G W X G W W X B G W X X G G G B X W G G W G G G G B G B B G G W X X 
W W B W B G X W B X X W X B G G W B X X X G X W W X B B X B G W X G W W X G G W W G W W X B B G 
X W G X G B W G B X W W W G G G X B B B G W B B G W W W X B W X X G G B B X X G G W X X G G W X 
B W B X X X B X W W X W B X G G X W G W B B B X X B X B G X X B W W W W X W X W W W W X B X G X 
G X G G X G B X X G X W X B X X G X B X G B G X W G G W B X B B G X B W B W B B W X X G W B G G 
G X B G B B X W X X G W X B B W W W B W G G X W X W X W X W W X W B G B X W X B W X X G B G B W 
B G X G X B G G G G X B G G W B W W W X G B X W W G X X G W W X X X W X B W B W W B B X X G G B 
W X X W W G G X W B G B W B X X G B B G G B G G G G X B G B X W B G G W B G X X X B B G W G X B 
B X W X G G X X G X W W X W G W B G W W G B B G X B W X B B X B G X W X X W X G B X G B B X W G 
W B G G G X G G B G G G X B B G X X W B B G G B G W B B X X X W W B X W B B X W W X W W W W B B 
G W W W W X B B G G W X W B G G B X G W W G W W G G B B W X B G X B W X G G X G X W G G X G W B 
G G W G B G G W W B X W W X B G X X W X W G B X B X B G X W W G G X G G G B W W W G G X G B B W 
G X B X W X W X X X G W B B G B W B B W W G G W B W X G W X W G X G W B W X X X B G B G W W G X 
B B G B X W W G G G X G B W G X B G W G X B B G W G W G X X G G B W G G G X G W W B B W X X W B 
G B G X G W G W W G B B X G G B G G G W X X G X X B W B G X W W G B B B G G W W B B B W X B B G 
W W G W G X G W X X W G G X G G X G X B X B X W G W B B G G X W X B B G W X X X B G W G W G X W 
X B W G X B W W G W B X B B X B W X G B X W G X B B B B X B X W B W B G G W W W G G X X W W W W 
B B W B G B X W G X G G X W B B X B G G X B X G X B W X G W W X W B W W B W B W W X G G G G B B 