G B B G W B W B B G X B B W X X X W G W W G G G 
X B X B X W G X B W G G B X X G W G X W B B W X 
X W G B G X B G B G B W G X G G X X X G B X W B 
B X G X W W W B W X G X W G G B G G X X X X G G 
G B W X G B X B X W G G X W B W X W W W X W G W 
B W G G G X X X G W W W X X B W W B X G X X G G 
W W G G X W X G B W B B X W X G W B X G G W G B 
B W G W W G G G X W X X X X G B W B G B X B X B 
G G X B B W B X G W X X X G B B W W B X B W B B 
X G W X B X W W B G W G B B G B W B G G B B W B 
G G G B B G X X G G W G G B G B X G B B X W X X 
G B W B G X B G B B W X G W B G W X G W B W B G 
G W W G B B B B X X B W X W B B W G X X G G W X 
B X W X B W X W X G B B W X G X G B W B B W G W 
W W X G W W B W G B B X X X W X W X W W W G W W 
W G B W X B X B B X W B G G B X X G G G W G B B 
W W G B X W X G B X G X W W X W B B B W W G X G 
G B B G W W G W W B W W B W W B X W B G X G B G 
B W X B W B W B W G B B W G X B G G W G B X G B 
B B G B G X W B W G W W X B G B X W B G W B W W 
X G W G B X X G W B B B W W W G G G G X W G W B 
B X X W B W B G W W G G G X W W B W X B B X X W 
G G W X X B W X G X W B B X G G G B G X X G W G 
B X X B X G G B W W G B X X W X G X X G X W B G 