G B B G W B B W X W B G 
W B G B G X G B X X W W 
G W G X W X W W X B B W 
G B B G G G B W X B X B 
X G W G B W B W W G W X 
G X B B B X B X G B W W 
X G X W B X W B X X X X 
W X B W B X X G G X W W 
X B X W G W W W G W W G 
G G G G B B G G X G B W 
G B W W B W G X X G X G 
W W X W X B W B G X W B 