X G G B X W W X G G W G W W X G X G W X X G W X 
X B X G B X X W X B W X B X B B G G G G B X G W 
X B X G G W G X G G B X G G G X B B W X B B W W 
B X G B B G B B G G G B W G W W W B X B X B W X 
W W G W W X W G X X W B G B W W X G X W B G G X 
G B G W B X W W X B X W B B B B X W B G B B B B 
X X W B G X W G B W B W W B W W W G G G X X X G 
B B B G B G X B X B W X B W W B X X G W B G X X 
B W W B W W G B G X B W G B G W X B X X G X G W 
X B G B X W X B W X W G X G G X W B G W W W G X 
X B W W B W G X B B X G B W B X G X B X W W W B 
X B G W X X W B G B X X B G B B X B B W W B W B 
B X G X B X W W G X B W X X X X G X B W X X B G 
G B X X G X G B B G B W W B B X G W G B X G X X 
B B X W G B W X B X G G G G B B X X X W B W G W 
G X B X B W W X X B X X B G X W X B B G B B X X 
X B W W G X G W B X G X G X W X W B G G W G W G 
W W W W W B G W W W W W X X B B G B B G X G W B 
B B W B X X W X G X G B X W G B X W G G B W W X 
W X G B X B W W X B G X W X G G B G W B G W G W 
X W X W B B W G B W B B X G B B G G W B G B X G 
W G B W W B G G W B X W G B X B X W W W W B X W 
W X B B W X X B B B B W X G X W G W B X W X X W 
B X B G X B W X B G B G W W X X W X B B W X W X