W X X G X B X G X X W X 
B B G X X B X B W G X X 
G X G G W W G G X B W B 
W X G X G X X W G G G X 
X X B B B B B X W B B X 
B G B W X G B B W W B W 
W B X G X G X X G B X W 
B X X W B W B G G X X W 
X W W G W B B B X W G G 
B G G W B X X G X X W G 
W B W W G W X X G W B X 
G G B B B W X W B W B B 