W W W X W G W X B X X B X B B W X W B G W W W W 
B B X B B W G B W W B B G X B W X W W B B G X W 
W W G W B X B G B X W X G X X G W X X W B G G W 
B G B X W B G B X G B W X X X B G B X B W B B X 
G X W W X W B B G W X B X X G G B G B W X X G G 
B B B G G X B W W B G G X G B W G G B W W X W W 
X W X G W X G B G B X X W B X W G X B G X B X G 
G X B G X X W X X W G X X X W W B X W G G B W X 
B X W X G B B X W B X G X X G G G W X W X B X X 
X G G W G X G W G B X G X W G W W B B B X B X G 
W B G B X B W W W B X G G B W B G X B B B X W W 
B G X B W G X W G X B G X B B X W B B W B X X W 
G B X X X G W B G G W G X B G W W B B B B W B B 
B W W G B G G X B B B W B G G G X B W W G G B X 
G B W X X W B X B X W X B X B B B G X G X B X X 
G W G X X B G W B B X W B B G B B W B B G G X G 
G W G G B B X B W G W X W G W G B W X G B W G W 
W G B X G W X G X W W X G X X G W B B X W B X B 
X B W B W W X G W X G X B W B W W G W B G W B W 
X G G X B X X W X X G X G W B B W W W G X B W B 
W X G G W W G X X W B G G W X G X W W B G B W X 
W G G G B X X B X B X B W X X G W X W X G B W G 
W X W W G W G B G B W G W G X W B B G B G G G X 
B X W W G B W B W G X X W X B W X X X G G W B X 